Event Number,Eye closing Frame,Eye closed Frame,Eye opening,Eye Fully Open,Class,Duration:,,,stdv
,218,225,227,243,H,25,,,6
,319,323,325,339,H,20,Total frames,1840,
,647,654,655,671,H,24,,,8
,685,697,699,722,F,37,,,17
,828,834,835,855,F,27,,,10
,893,899,903,920,F,27,,,11
,928,935,936,960,F,32,,,10
,1082,1094,1097,1115,F,33,,,17
,1124,1133,1137,1159,F,35,,,13
,1498,1507,1508,1551,F,53,,,10
,1608,1617,1619,1637,F,29,,,8
,1760,1766,1767,1787,H,27,,,
