Event Number,Eye closing Frame,Eye Closed Frame,Eye opening,Eye Fully Open,Class,Duration:,,,stdv
,184,195,197,217,F,33,,,5
,240,247,249,260,H,20,Total frames,1515,
,292,301,302,334,F,42,,,6
,400,409,411,433,F,33,,,1
,442,449,452,470,F,28,,,
,534,541,542,551,H,17,,,3
,566,571,572,585,H,19,,,7
,726,734,735,754,H,28,,,
,898,908,909,929,H,31,,,18
,990,996,997,1010,H,20,,,
,1212,1222,1223,1249,H,37,,,
