Event Number,Eye closing Frame,Eye Closed Frame,Eye opening,Eye Fully Open,Class,Duration:,,,stdv
83,126,n/a,133,140,H,14,,,3
84,168,n/a,172,180,H,12,Total frames,4540,
85,1870,n/a,1876,1882,H,12,,,10
86,2117,2122,2125,2139,F,22,,,8
87,2160,n/a,2166,2175,H,15,,,
88,2437,n/a,2443,2447,H,10,,,11
89,3044,n/a,3055,3066,H,22,,,
90,3514,n/a,3522,3528,H,14,,,
91,4191,n/a,4201,4209,H,18,,,15
92,4226,n/a,4231,4237,H,11,,,1
