Event Number,Eye closing Frame,Eye Closed Frame,Eye opening,Eye Fully Open,Class,Duration:,,,stdv
73,33,n/a,38,44,H,11,,,1
74,599,n/a,604,610,H,11,total frames,2692,2
75,1438,1441,1445,1455,F,17,,,7
76,1497,1501,1503,1515,F,18,,,1
77,1546,n/a,1551,1559,H,13,,,13
78,1783,1787,1789,1800,F,17,,,4
79,1837,1843,1844,1852,F,15,,,3
80,1942,1947,1950,1958,F,16,,,5
81,2243,2247,2248,2255,F,12,,,6
82,2641,2644,2646,2653,F,12,,,5
