Event Number,Eye closing Frame,Eye Closed Frame,Eye opening,Eye Fully Open,Class,Duration:,,,stdv
,65,70,71,84,F,19,,,18
,88,93,94,103,F,15,Total frames,596,
,113,116,117,128,F,15,,,16
,152,157,158,166,H,14,,,3
,186,189,190,197,F,11,,,
,331,334,335,344,H,13,,,1
,362,368,369,386,F,24,,,9
,403,407,408,414,F,11,,,12
,420,426,427,434,H,14,,,
,519,524,525,535,F,16,,,11
